{
    "width" : 12,
    "depth" : 12,

    "sunlight" : [ -1, 1, 0 ],

    "altitude" : [
        0, 0, 0, 0, 0, 0, 0, 0, 0, 0, 0, 0,
        0, 0, 0, 0, 0, 0, 0, 0, 0, 0, 0, 0,
        0, 0, 1, 1, 1, 1, 1, 1, 1, 1, 0, 0,
        0, 0, 1, 1, 1, 1, 1, 1, 1, 1, 0, 0,
        0, 0, 1, 1, 2, 2, 2, 2, 1, 1, 0, 0,
        0, 0, 1, 1, 2, 3, 3, 2, 1, 1, 0, 0,
        0, 0, 1, 1, 2, 3, 3, 2, 1, 1, 0, 0,
        0, 0, 1, 1, 2, 2, 2, 2, 1, 1, 0, 0,
        0, 0, 1, 1, 1, 1, 1, 1, 1, 1, 0, 0,
        0, 0, 1, 1, 1, 1, 1, 1, 1, 1, 0, 0,
        0, 0, 0, 0, 0, 0, 0, 0, 0, 0, 0, 0,
        0, 0, 0, 0, 0, 0, 0, 0, 0, 0, 0, 0
    ],

    "trees" : [
        {
            "x" : 2.5,
            "z" : 2.5
        },
        {
            "x" : 5.5,
            "z" : 5.5
        }
    ],

    "roads" : [
        {
            "width" : 3,
            "spine": [
                2.5, 4,
                2.5, 1.5,
                8.5, 2.5,
                8.5, 2.5
            ]
        }
    ]

}